.............
...BBBBBB....
...BAAAAB....
...BBBBBB....
.............
.............
........999..
..444444444..
..999........
.............
......P......
.............
.............